#############
#  f a k t  #
#      \    #
# ! @       #
#########D###
###############
# !   @ ! !#  #
#@    @    #  #
#@####    !# !#
# #D@  #####  #
# ###### !    #
#             #
#  @     @!!  #
###############
