######################################################
#        #   @              #####                    #
D  !     @   #        ###         ######             #
#        #   #             #####                     #
##########   #    ###############     #######        #
#       !    #    @             @                    #
#            #   !@             @       #######      #
#@############    @   ########  @             #      #
#                 @   #\    @   @             #      #
# !############ ! @   ########  @       #######      #
#                 @         !   @             #      #
#                 ###############             #      #
#                                       #######      #
#                                                    #
######################################################
