###############
# !   @ ! !#  #
#@    @    #  #
#@####    !# !#
# #D@  #####  #
# ###### !    #
#             #
#\ @     @!!  #
###############
