#############
#  f a k t  #
#      \    #
# ! @       #
#########D###
