##############################################
# \           #       #       #  #           #
#            ##   #   #    #  #   ##         #
#          #@     #     @   #      !@#       #
#            ##   #   #    #  #   ##         #
#             #       #       #  #           #
#           ########################         D
#           @        !    !        @         #
#           @    !           !     @         #
#           @                      @         #
#           @       !        !     @         #
#           @    !                 @         #
#           @        !    !        @         #
##############################################
